####################
#C..M..R..B..S..W..#
#.R.R.R.......R....#
#....M......B......#
#..B.....W.........#
#......R.......M...#
#..........R.......#
#..................#
#..........B.......#
#......M...........#
#..................#
#..R...........R...#
#..................#
#....B......M......#
#..................#
#P..I.........L....#
#..................#
#..................#
#..................#
####################
