####################
#C..M..R..B..S..W..#
#.R.R.R.......R....#
#....M......B......#
#..B...............#
#......R.......M...#
#..........R.......#
#....W.............#
#..........B.......#
#......M...........#
#..................#
#..R...........R...#
#..................#
#....B......M......#
#..................#
#P......I......L...#
#..................#
#..................#
#..................#
####################
