####################
#C..M..R......S....#
#......R...........#
#..........B.......#
#.......M..........#
#..................#
#..R...............#
#..................#
#............W.....#
#..................#
#..................#
#.....B............#
#..................#
#.........M........#
#..................#
#P.................#
#..................#
#..................#
#..................#
####################
