####################
#C..M..R......S....#
#......R...........#
#....B.............#
#.......M..........#
#..................#
#..R...............#
#..................#
#............W.....#
#..................#
#........M.........#
#.....B............#
#..................#
#.........R........#
#..................#
#P.................#
#..................#
#..................#
#..................#
####################
