####################
#C..M........S.....#
#R#R#R#R#R#R#R#R#R.#
#....M......B....W.#
#..B.....W.........#
#......R.......M...#
#......W...R.......#
#..........B.......#
#......M...........#
#..................#
#..R...........R...#
#..................#
#....B......M......#
#.........W........#
#P..I....M....L....#
#..................#
#..................#
#..................#
#..................#
####################
