####################
#C..M..R..B..S.....#
#......R...........#
#....B.............#
#.......M......W...#
#..................#
#..R...............#
#..................#
#............R.....#
#..................#
#........M.........#
#.....B............#
#..................#
#.........R........#
#..................#
#P.................#
#..................#
#..................#
#..................#
####################
