####################
#C....M.....S......#
#....R....B........#
#..................#
#.........M........#
#..................#
#..R...............#
#..................#
#.........W........#
#..................#
#..................#
#..................#
#..................#
#..................#
#..................#
#..................#
#..................#
#P.................#
#..................#
####################
